10
10
##########
#.........
##..#.##.#
#...#..#.#
####.#.###
.....#...#
####.##.##
##...##.##
##.......#
##########
